11	12									
3	14	14	14	14	3	14	14	14	14	3
3	14	14	14	14	3	14	14	14	14	3
3	14	14	14	14	3	14	14	14	14	3
3	14	14	14	14	3	14	14	14	14	3
3	14	14	14	14	3	14	14	14	14	3
3	14	14	14	14	14	14	14	14	14	3
3	14	14	14	14	14	14	14	14	14	3
3	14	14	14	14	14	14	14	14	14	3
3	14	14	14	14	14	14	14	14	14	3
3	14	14	14	14	14	14	14	14	14	3
3	14	14	14	14	14	14	14	14	14	3
3	3	3	3	3	3	3	3	3	3	3

