15	15													
9	9	9	9	9	9	9	9	9	9	9	9	9	9	9
9	15	15	15	15	9	9	9	9	9	15	15	15	15	9
9	15	9	9	9	9	9	9	9	9	9	9	9	15	9
9	15	9	15	15	15	9	9	9	15	15	15	9	15	9
9	15	9	15	9	9	9	9	9	9	9	15	9	15	9
9	9	9	15	9	9	9	9	9	9	9	15	9	9	9
9	9	9	9	9	9	9	9	9	9	9	9	9	9	9
9	9	9	9	9	9	9	9	9	9	9	9	9	9	9
9	9	9	9	9	9	9	9	9	9	9	9	9	9	9
9	9	9	15	9	9	9	9	9	9	9	15	9	9	9
9	15	9	15	9	9	9	9	9	9	9	15	9	15	9
9	15	9	15	15	15	9	9	9	15	15	15	9	15	9
9	15	9	9	9	9	9	9	9	9	9	9	9	15	9
9	15	15	15	15	9	9	9	9	9	15	15	15	15	9
9	9	9	9	9	9	9	9	9	9	9	9	9	9	9
